########################################
#.......#................#.............#
#.......#................#.............#
#.......#................#.............#
#.......#................#.............#
#.......#................#.............#
#.......######...........#......########
#......................................#
#......................................#
#......................................#
#..@...................................#
#######......#######......#######......#
#..................#...................#
#..................#...................#
#..................#...................#
#..................#...................#
#......######......#######.......#######
#..................#...................#
#..................#...................#
#..................#...................#
#..................#...................#
########################################